+---+---+---+---+---+---+---+---+---+---+---+---+---+---+---+---+---+---+---+---+---+---+---+---+---+
  x |           |                   |       |                   |                   |       |       |
+   +   +   +---+   +   +---+---+   +   +   +   +---+---+---+   +---+---+---+---+   +---+   +   +---+
|       |       |   |       |   |       |   |   |                                           |       |
+---+---+---+   +---+---+   +   +---+---+   +   +---+   +---+---+---+---+---+---+   +---+---+---+   +
|   |           |               |       |       |       |               |           |           |   |
+   +   +---+---+   +---+---+---+   +   +---+---+   +   +---+---+---+   +   +---+---+   +---+   +   +
|       |       |       |       |   |           |   |   |           |   |   |       |   |       |   |
+   +---+   +   +   +---+   +   +   +---+---+   +   +---+   +---+   +   +   +   +   +   +   +---+   +
|   |       |   |       |   |   |       |       |           |       |   |   |   |   |   |   |       |
+   +   +   +   +---+   +   +   +---+   +   +---+---+---+---+   +---+   +   +---+   +   +   +   +---+
|       |   |   |       |   |           |           |       |       |   |           |   |   |       |
+---+---+---+   +   +---+   +---+---+---+---+---+   +   +---+---+   +   +---+---+---+   +   +---+   +
|       |       |       |   |   |       |       |   |       |       |       |       |   |           |
+   +   +   +---+---+   +   +   +   +   +   +   +   +---+   +   +---+---+   +   +   +   +---+---+---+
|   |   |       |   |   |           |   |   |   |   |   |   |               |   |   |   |           |
+   +---+   +   +   +   +---+---+---+   +   +   +   +   +   +---+   +---+---+   +   +   +   +---+   +
|       |   |           |               |   |   |   |   |   |   |   |       |   |           |       |
+---+   +   +---+   +---+   +---+---+---+   +   +   +   +   +   +   +---+   +   +---+   +---+   +   +
|       |   |           |   |   |           |   |   |   |   |   |           |   |       |   |   |   |
+   +---+   +   +---+---+   +   +   +---+---+---+   +   +   +   +---+---+---+   +   +---+   +   +---+
|   |       |   |       |   |   |                   |   |   |       |           |           |       |
+   +   +   +   +   +   +   +   +---+---+---+---+---+   +   +---+   +   +---+---+---+---+---+---+   +
|       |   |       |   |   |       |       |       |   |       |           |               |       |
+---+---+---+---+---+   +   +   +---+   +   +   +   +   +---+   +---+---+   +   +---+---+   +---+---+
|       |               |   |   |       |       |           |           |   |   |           |       |
+   +   +   +---+---+---+   +   +   +---+---+---+   +   +---+---+   +   +   +   +   +---+   +   +   +
|   |   |   |           |       |       |       |   |       |   |   |   |   |   |   |           |   |
+   +---+   +   +---+   +   +---+---+   +   +   +---+---+   +   +   +   +   +---+   +   +   +---+   +
|   |       |   |       |   |           |   |               |       |   |   |       |   |   |       |
+   +   +---+   +   +---+   +   +---+---+   +---+---+---+---+---+---+   +   +   +---+   +   +---+   +
|   |   |       |               |           |       |       |       |   |       |       |       |   |
+   +   +   +---+---+---+---+---+   +---+---+   +   +   +   +   +   +   +---+---+   +---+---+   +---+
|   |   |   |           |   |       |       |   |   |   |       |       |       |   |       |       |
+   +   +   +   +   +   +   +   +---+   +   +   +   +   +---+   +---+---+   +   +---+   +   +   +   +
|       |   |   |   |       |   |       |       |   |       |   |       |   |   |       |   |   |   |
+---+   +   +   +---+---+---+   +   +---+---+---+   +---+   +   +   +---+   +   +   +---+   +   +   +
|           |   |               |               |   |       |   |           |       |   |       |   |
+   +---+---+   +   +---+   +---+---+---+   +   +   +---+---+   +---+---+   +---+---+   +---+---+   +
|   |       |   |   |           |           |   |           |   |       |           |   |       |   |
+---+   +---+   +   +   +   +---+   +---+---+---+---+---+   +   +   +   +---+---+   +   +---+   +   +
|           |       |   |           |               |       |       |   |       |       |       |   |
+   +---+   +---+---+   +---+---+---+   +---+---+   +   +---+---+   +   +   +   +   +---+   +---+---+
|   |   |           |       |           |       |   |               |   |   |       |       |       |
+   +   +---+   +   +---+   +   +---+---+   +   +   +---+---+   +---+   +   +---+---+   +---+   +   +
|   |   |       |           |   |           |   |               |           |       |   |       |   |
+   +   +   +---+---+---+---+   +---+   +---+---+---+---+---+---+   +   +---+   +   +   +---+---+   +
|       |   |       |       |       |   |       |                   |           |                   |
+---+---+   +   +   +   +   +---+   +   +   +   +   +---+---+---+---+---+---+---+---+   +---+---+---+
|               |       |       |       |   |       |                                             z  
+---+---+---+---+---+---+---+---+---+---+---+---+---+---+---+---+---+---+---+---+---+---+---+---+---+
