+---+---+---+---+---+---+---+---+---+---+
  x     |           |           |       |
+---+   +   +---+   +   +---+   +   +   +
|       |   |   |   |   |   |   |   |   |
+   +---+   +   +   +   +   +   +   +   +
|           |   |   |       |   |   |   |
+---+---+---+   +   +---+---+   +---+   +
|               |           |       |   |
+   +---+---+---+   +---+---+---+   +   +
|               |   |       |       |   |
+---+---+   +   +   +   +   +   +---+   +
|   |       |   |   |   |   |   |       |
+   +   +---+---+   +   +   +   +---+   +
|   |   |       |       |       |       |
+   +   +   +   +   +---+---+---+   +   +
|   |       |                       |   |
+   +---+---+---+   +---+---+---+---+   +
|   |               |               |   |
+   +   +---+---+---+   +---+---+   +   +
|       |                       |     z  
+---+---+---+---+---+---+---+---+---+---+