+---+---+---+---+---+
  x     |           |
+---+   +   +---+   +
|   |   |       |   |
+   +   +---+   +   +
|   |           |   |
+   +---+---+   +   +
|   |           |   |
+   +   +---+---+   +
|       |         z  
+---+---+---+---+---+