+---+---+---+---+---+---+---+---+---+---+---+---+---+---+---+---+---+---+---+---+---+---+---+---+---+---+---+---+---+---+---+---+---+---+---+---+---+---+---+---+---+---+---+---+---+---+---+---+---+---+
  x         |       |       |           |       |       |           |           |       |               |           |       |       |   |                   |                   |       |               |
+---+---+   +   +   +   +   +   +---+   +   +   +   +   +   +   +---+   +---+   +   +   +---+   +---+---+   +---+   +---+   +   +   +   +   +---+   +---+---+   +---+---+---+   +   +   +   +---+---+   +
|   |           |   |   |   |       |       |   |   |   |   |           |       |   |       |               |       |       |   |   |       |   |                   |           |   |       |           |
+   +   +   +---+   +   +   +---+   +---+---+   +   +   +   +---+---+---+   +---+   +---+   +---+---+---+---+---+   +   +---+   +   +---+---+   +---+---+---+   +   +   +---+---+   +---+---+   +---+---+
|       |       |   |   |           |   |       |   |       |               |       |       |       |   |           |   |       |   |               |           |   |       |       |       |   |       |
+---+---+---+   +   +---+---+   +---+   +   +---+   +---+---+   +---+---+   +   +---+   +---+   +   +   +   +---+---+   +---+---+   +---+---+   +   +---+---+---+   +---+   +   +---+   +   +   +   +   +
|   |           |   |           |       |           |       |   |       |       |               |           |       |   |       |       |       |       |       |   |   |       |       |       |   |   |
+   +   +---+---+   +   +---+   +   +---+---+   +---+   +---+   +   +   +---+---+   +---+---+---+   +---+---+   +   +   +   +   +---+   +   +---+---+   +   +   +   +   +---+---+---+   +---+---+   +   +
|   |           |       |       |                       |           |           |           |   |       |   |   |   |       |       |   |           |   |   |   |   |                   |           |   |
+   +---+   +   +---+---+---+---+---+---+---+---+---+---+   +---+---+---+---+   +---+---+   +   +---+   +   +   +   +---+---+---+   +   +---+---+   +   +   +   +   +   +---+---+---+   +   +   +---+   +
|           |       |                   |                   |                   |           |               |   |           |   |   |       |       |       |       |               |       |   |       |
+   +---+---+---+   +   +---+---+   +---+   +---+---+---+---+   +---+---+---+---+---+   +---+---+---+   +---+   +---+---+   +   +   +---+   +   +---+---+---+---+---+---+---+---+---+---+---+   +   +---+
|   |               |   |       |       |               |       |                   |   |           |           |       |       |       |       |   |           |       |                       |       |
+   +   +---+---+---+   +   +   +---+   +   +---+---+   +   +---+   +---+---+---+   +---+   +---+   +---+---+---+---+   +   +   +---+   +   +---+   +   +---+   +---+   +   +---+---+---+---+---+---+   +
|   |       |       |       |   |       |   |           |           |           |   |       |           |       |       |   |   |       |       |       |   |               |           |               |
+   +---+---+   +   +---+---+---+   +---+---+   +---+---+---+---+---+   +---+   +   +   +---+---+   +   +   +   +   +---+   +   +---+   +---+   +---+---+   +---+---+   +---+---+---+   +---+---+---+---+
|   |           |                   |           |   |       |           |   |   |       |           |       |   |   |       |       |   |   |       |       |       |       |       |                   |
+   +   +---+   +---+---+---+---+---+   +---+---+   +   +   +---+   +   +   +   +---+---+   +---+---+   +---+   +   +---+---+---+   +   +   +---+   +   +---+   +   +---+   +   +   +---+   +---+---+---+
|   |   |   |           |       |       |       |       |       |   |   |       |           |       |       |   |                   |   |       |   |       |   |       |       |       |               |
+   +   +   +---+---+   +   +---+   +   +   +   +---+---+---+   +---+   +---+---+---+---+   +   +   +---+---+   +---+---+---+---+---+   +   +   +   +---+   +   +---+   +   +---+---+   +---+---+---+   +
|       |               |   |       |   |   |       |                   |                   |   |   |               |       |       |       |   |   |           |   |   |   |       |               |   |
+---+---+---+---+---+---+   +   +---+   +   +---+   +   +---+   +---+   +   +---+---+---+---+   +   +   +---+---+---+   +   +---+   +---+---+   +   +   +   +---+   +   +   +   +---+---+---+---+   +   +
|                       |           |   |   |       |       |   |       |                       |   |       |   |       |           |           |   |   |   |   |       |   |       |           |   |   |
+   +---+---+---+---+   +---+---+   +---+   +   +---+---+   +   +---+---+   +---+---+   +---+---+---+---+   +   +   +---+---+---+   +   +---+---+   +---+   +   +---+---+   +   +   +   +---+   +   +   +
|       |           |               |       |           |   |   |       |   |               |                   |       |       |   |   |                   |                   |       |       |       |
+---+   +   +---+   +---+---+---+---+   +---+---+---+   +---+   +   +   +---+   +---+---+   +   +   +---+   +---+---+   +   +   +   +   +   +---+   +---+---+   +---+---+   +---+---+---+   +---+---+---+
|       |   |   |               |       |           |           |   |           |       |   |   |       |           |       |   |   |   |   |       |           |           |               |           |
+   +---+   +   +---+---+---+   +   +---+   +   +   +---+---+---+   +---+---+---+   +   +---+   +---+   +---+---+---+---+   +   +   +   +   +   +---+   +---+---+   +---+---+   +---+---+---+   +---+   +
|   |       |   |           |       |       |   |       |       |   |               |       |       |       |               |   |       |   |       |   |   |       |       |   |       |   |   |       |
+   +---+   +   +   +   +   +---+---+---+---+---+---+   +   +   +   +   +---+---+---+---+   +---+   +---+   +   +---+---+---+   +---+---+   +---+   +   +   +   +---+   +   +---+   +   +   +   +   +---+
|       |   |       |   |   |   |               |   |   |   |   |   |   |       |       |       |       |       |   |           |       |   |       |       |           |       |   |   |       |       |
+---+   +   +---+---+---+   +   +   +---+   +   +   +   +   +---+   +   +   +   +   +   +---+   +   +---+---+---+   +   +---+---+   +   +   +---+---+---+   +---+   +---+---+   +---+   +   +---+   +   +
|       |       |       |   |   |   |       |           |   |       |       |       |       |       |               |               |   |       |           |   |   |           |       |   |       |   |
+   +---+---+   +   +   +   +   +   +---+---+---+   +---+   +   +---+---+---+---+---+   +---+---+---+   +   +---+---+---+---+---+---+   +---+   +   +---+   +   +   +   +---+---+   +---+   +   +---+---+
|           |       |   |   |       |       |   |           |       |       |                           |               |       |   |           |       |   |       |           |           |   |       |
+---+---+   +---+   +   +   +---+---+   +   +   +   +---+---+   +---+   +---+   +---+   +---+---+---+---+   +---+---+   +---+   +   +---+---+---+---+   +---+---+---+---+---+   +---+   +---+   +   +   +
|       |   |       |   |       |       |   |   |   |                   |           |           |       |   |           |       |                       |                   |           |           |   |
+   +   +   +   +---+   +---+   +---+---+   +   +   +   +---+   +---+---+   +---+---+---+---+   +   +   +   +   +---+---+   +---+---+---+---+---+---+---+   +---+---+---+   +---+---+---+---+---+---+   +
|   |   |       |   |   |       |       |   |           |       |           |   |           |   |   |       |       |       |       |               |       |           |           |       |       |   |
+   +   +   +---+   +   +   +---+   +   +   +---+   +---+   +---+   +---+---+   +   +---+   +   +---+   +---+---+   +   +---+   +   +   +---+---+   +---+---+   +---+---+---+---+   +---+   +   +   +   +
|   |       |   |   |       |       |           |       |   |       |       |   |       |   |       |       |   |       |       |   |   |           |       |                                   |       |
+   +---+---+   +   +---+---+   +---+   +---+   +---+   +   +   +---+   +   +   +   +---+   +---+   +   +   +   +---+---+   +---+---+   +---+   +---+   +   +---+   +---+---+---+---+---+---+   +---+---+
|   |           |   |           |   |   |   |   |       |   |           |       |       |   |       |   |       |       |   |       |       |   |       |               |           |       |           |
+   +   +---+   +   +   +---+---+   +   +   +   +---+   +---+---+---+---+   +---+---+   +   +   +---+---+---+---+---+   +   +   +   +---+   +   +   +---+---+---+---+---+   +---+   +   +---+---+---+   +
|       |       |   |               |       |       |   |       |           |       |   |       |       |           |   |       |       |   |   |           |   |           |       |       |           |
+---+---+---+   +   +---+---+---+---+---+---+---+   +---+   +---+   +---+---+   +   +   +---+---+   +   +---+   +   +   +---+---+---+   +   +   +---+---+   +   +   +---+---+   +---+   +   +---+   +---+
|               |       |               |       |   |               |       |   |       |       |   |   |       |   |       |       |   |   |       |   |   |   |   |           |       |       |       |
+   +---+---+---+---+   +   +---+---+   +   +   +   +   +   +---+   +---+   +   +---+---+   +   +---+   +   +---+   +   +---+   +   +   +   +---+   +   +   +   +   +   +---+---+   +---+---+   +---+   +
|           |       |   |           |   |   |   |       |       |       |   |               |   |       |   |   |   |       |   |       |   |   |   |               |   |           |           |       |
+---+---+   +   +   +   +---+---+   +---+   +   +---+---+---+   +---+   +   +---+---+---+---+   +   +---+   +   +   +---+   +   +   +   +   +   +   +---+---+---+---+   +---+---+   +   +---+---+   +---+
|           |   |   |   |                   |           |   |   |   |       |       |           |   |       |       |       |   |   |   |       |                   |               |       |       |   |
+   +---+---+   +   +   +   +---+   +---+---+---+   +   +   +   +   +---+---+   +---+   +---+---+   +   +   +---+---+   +---+---+   +---+---+---+---+---+---+   +   +---+---+---+---+---+   +   +---+   +
|               |   |   |   |   |               |   |           |           |           |       |   |   |       |   |       |           |                       |   |       |               |   |       |
+---+---+   +   +   +   +   +   +---+---+---+---+   +---+---+---+---+---+   +   +---+---+   +   +   +   +---+   +   +---+   +   +---+   +---+---+   +---+---+---+---+   +   +   +---+---+---+   +---+   +
|       |   |   |       |   |   |   |           |                           |               |   |       |   |   |       |       |   |       |       |   |           |   |       |       |       |       |
+   +   +   +---+---+---+   +   +   +   +---+   +---+   +---+---+   +---+   +---+---+   +   +   +   +---+   +   +---+   +   +---+   +---+   +   +---+   +   +---+   +   +---+---+   +   +   +---+   +---+
|   |   |       |       |       |           |                   |       |           |   |   |       |           |       |       |           |       |           |       |           |   |       |       |
+   +---+---+   +   +   +---+---+---+---+   +---+---+---+---+---+---+   +   +---+   +---+   +---+---+---+---+---+   +   +   +   +---+---+---+---+   +---+---+   +---+---+   +---+---+   +---+   +---+   +
|               |   |   |       |           |                           |   |       |       |           |           |       |               |   |               |       |   |   |       |           |   |
+---+---+---+---+   +   +   +   +   +---+---+   +---+---+---+---+---+---+---+   +---+   +---+---+   +   +   +---+---+---+---+---+---+---+   +   +---+---+   +---+   +   +   +   +   +---+   +---+   +   +
|   |           |   |       |   |           |       |       |       |       |   |   |   |       |   |           |       |       |       |   |       |   |           |       |   |       |       |   |   |
+   +   +---+   +   +---+---+   +---+---+   +---+   +   +   +   +   +   +   +   +   +   +   +   +---+---+   +   +---+   +   +   +   +---+   +---+   +   +---+---+---+   +---+   +---+   +---+   +---+   +
|       |       |   |           |       |   |       |   |       |   |   |       |   |   |   |       |       |       |   |   |   |   |           |   |           |       |   |           |   |           |
+---+   +   +---+   +   +---+---+   +---+   +   +---+   +---+---+   +   +---+---+   +   +   +---+   +---+   +---+   +   +---+   +   +   +---+---+   +   +---+   +   +---+   +---+---+---+   +---+   +   +
|       |           |               |       |                   |   |               |       |   |               |       |       |   |   |           |       |   |           |               |       |   |
+   +---+---+---+---+---+---+---+---+   +---+---+---+---+---+---+   +---+---+---+---+---+---+   +---+---+---+---+---+---+   +---+   +   +   +---+---+---+   +   +---+---+   +---+   +   +---+   +---+---+
|       |       |       |               |           |       |       |       |                   |       |               |       |           |       |       |           |   |       |   |   |   |       |
+   +   +   +   +   +---+   +---+---+---+   +---+---+   +   +   +---+   +   +   +   +---+---+---+---+   +   +---+---+   +   +---+---+   +---+---+   +   +---+---+---+   +---+   +---+   +   +   +   +   +
|   |   |   |           |   |       |   |               |       |       |   |   |   |                       |       |       |           |           |           |           |   |       |   |       |   |
+   +   +   +---+---+   +   +   +   +   +---+---+---+   +---+---+   +---+   +   +   +---+   +---+---+   +---+   +   +---+---+   +---+---+   +---+---+   +---+---+   +---+   +   +   +---+   +---+---+   +
|   |       |       |   |       |   |   |       |       |           |   |   |   |           |           |       |   |       |   |                   |   |       |   |           |       |   |           |
+   +---+   +---+   +   +---+---+   +   +   +---+   +---+   +---+---+   +   +   +---+   +---+   +---+---+   +   +   +---+   +   +   +---+   +---+   +   +   +   +   +   +---+---+---+   +   +   +---+---+
|       |           |   |   |       |           |       |   |       |   |       |       |   |       |       |   |       |       |   |       |       |   |   |       |       |           |   |           |
+   +---+---+---+---+   +   +   +---+   +---+   +---+   +   +---+   +   +---+---+   +---+   +---+   +---+---+---+---+   +---+   +   +   +---+---+   +---+   +---+---+---+   +   +---+   +   +---+---+   +
|   |       |       |               |       |       |   |       |   |           |   |           |           |       |       |   |   |   |       |   |       |           |   |       |   |               |
+   +   +   +   +---+---+---+---+---+---+   +---+---+   +---+   +   +---+---+   +   +   +   +   +---+   +---+   +---+---+   +   +---+   +   +   +   +   +---+   +---+   +   +   +   +   +---+---+---+---+
|   |   |   |                           |           |           |       |   |       |   |   |       |       |       |       |       |   |   |       |   |   |   |   |       |   |   |   |       |       |
+   +---+   +---+---+---+---+---+---+   +   +---+   +   +---+---+   +   +   +---+---+   +   +---+   +---+   +---+   +   +---+---+   +   +   +---+---+   +   +   +   +---+---+---+   +   +---+   +   +   +
|               |           |       |   |       |       |           |   |   |           |   |   |       |       |       |       |       |           |   |           |       |       |       |   |   |   |
+---+---+   +   +---+---+   +   +---+   +---+   +---+---+   +   +---+   +   +   +   +---+   +   +   +   +---+   +   +---+   +   +---+---+---+---+   +   +---+   +---+---+   +   +---+---+   +   +   +   +
|       |   |               |       |           |           |       |   |       |       |       |   |       |       |   |   |   |                   |       |               |       |       |   |   |   |
+   +   +   +---+---+---+---+---+   +---+---+---+   +---+---+---+---+   +---+---+---+---+---+---+   +---+   +   +---+   +   +---+   +---+---+---+---+   +---+---+---+---+---+   +---+   +---+   +---+   +
|   |       |                   |       |               |               |                       |       |       |       |       |           |           |       |               |       |       |       |
+   +---+---+   +---+---+---+   +---+   +---+---+---+   +   +---+---+---+---+---+   +---+---+   +   +---+---+---+   +---+---+   +---+   +   +   +   +---+   +   +---+   +   +---+   +---+---+   +   +   +
|           |   |           |           |           |   |           |       |       |       |   |       |       |   |       |           |       |       |   |           |   |       |   |       |   |   |
+---+---+   +   +   +   +---+---+---+---+   +---+   +   +---+---+   +---+   +   +---+   +   +---+---+   +---+   +   +   +---+---+---+---+---+---+---+   +   +---+---+---+---+   +---+   +   +   +   +   +
|           |   |   |           |           |           |       |           |       |   |       |       |       |   |           |               |       |       |       |       |       |   |       |   |
+   +---+---+   +   +---+---+   +---+---+---+   +   +---+   +   +   +   +---+---+   +   +---+   +   +   +   +---+   +---+   +   +   +---+---+   +   +---+---+   +   +   +   +---+   +---+   +---+---+   +
|           |   |   |       |               |   |   |       |       |           |       |   |       |   |       |           |       |       |       |           |   |       |           |       |   |   |
+---+---+   +   +   +   +   +---+---+---+   +---+   +   +---+---+---+---+---+   +---+   +   +---+---+---+---+   +---+---+---+---+---+   +   +---+---+   +---+---+   +---+---+---+   +   +---+   +   +   +
|       |   |       |   |       |                   |   |       |       |       |   |   |   |               |   |                   |   |               |                           |       |   |       |
+---+   +   +---+---+   +---+   +---+   +---+---+---+   +   +---+   +---+   +---+   +   +   +   +   +   +   +   +   +---+---+---+---+   +   +---+---+---+   +---+---+   +---+---+   +---+---+   +---+---+
|       |           |   |       |       |               |       |           |       |           |   |   |       |               |       |   |   |           |       |           |       |           |   |
+   +---+   +   +   +   +   +---+   +---+   +---+---+---+   +   +---+---+   +   +---+---+   +---+   +   +---+---+---+---+   +---+   +---+   +   +   +---+---+   +---+---+   +---+---+---+   +   +   +   +
|       |   |   |       |           |   |       |       |   |           |       |           |   |   |       |       |       |       |       |       |   |               |           |       |   |       |
+   +---+   +   +---+---+   +---+---+   +---+   +---+   +   +---+---+   +---+---+   +---+---+   +   +---+   +   +   +   +   +   +---+---+---+---+---+   +   +---+   +---+---+---+   +   +---+   +---+   +
|   |       |   |       |   |       |               |       |       |   |       |       |   |           |       |   |   |       |       |       |       |       |               |       |           |   |
+   +   +---+   +   +---+   +   +   +---+---+---+   +---+---+---+   +   +   +   +   +   +   +---+---+---+---+---+   +   +---+---+---+   +---+   +   +---+---+   +---+---+   +   +---+---+   +---+---+   +
|       |       |           |   |                                   |       |       |       |                       |                           |               |           |               |         z  
+---+---+---+---+---+---+---+---+---+---+---+---+---+---+---+---+---+---+---+---+---+---+---+---+---+---+---+---+---+---+---+---+---+---+---+---+---+---+---+---+---+---+---+---+---+---+---+---+---+---+